##################################################################################################
#K............#######.......................................................+.#.......+..........#
#.......M.....#.............W........##................M......................#..................#
#.............#......................##.......................................#..........M.......#
#.............#....................####.......................................#..................#
#.............#.....+.........................................................#..................#
#.....M...............................................#.......................#....M.............#
#..................................M..................######...M..............#.............##.###
#..............M........#.............................#.......................#.............#....#
#..!....................#................W.....................................................W.#
#......................##.............................#.....................................#....#
#...................................................................#.......................#....#
#...................................................................#.......................######
#..........W..........................................#..........................................#
#...................................M............................................................#
#...........................................................................@....................#
#................................................................................................#
#............................#...................+#..............................................#
#............................#....................#..........#..........##########################
#...W.........W..............#..........+.........#..............................................#
#............................#....................#......................................M.......#
#..................M.........#####................#..............................................#
#................................#................#............W.................................#
#............#...................#................#....................................+.........#
#............#...................#......M.........#..............................................#
#..........###...................#................#.........................W....................#
#................................#................##########################################.....#
#.................................................#..............................................#
#.................................................#..............................................#
#..............###................................#.!............................................#
#.......................######....................#....................M.........................#
#.................................................#..............................................#
#.................................................#..............................M...............#
#.................................................#......W.......................................#
####################..............................#..............................................#
#.+.......................................#.......#.........................................W....#
#......................M..................#...W...#........................M.....................#
#.........................................#.......#..............................................#
#....W............................................#..............................................#
##################################################################################################